11111111
1PE000C1
10111101
1C011001
11111111