11111111
1P000001
10111101
100C1001
1011M001
100000E1
11111111