111111111111111111111111111111111111
100000000000000C00000C000000000001E1
10111000000000000P000000000110001001
101C1010001011111101000M000110001011
1010101000100M0000C100000001100010M1
101000100011111011111011100110000001
101111100000000000000001100000111001
100000000M00111111100000110000001001
101111111111111111111111111111111101
10000000000000000C000M00C00000000001
111111111111111111111111111111111111