111111111111111111111111111111111111111111111111111111
100000000000000000000000000000000000000000000000011111
1000000P000000001111111111111111000000000000001111C111
100111000000000000000000001111110000000000001111000001
100M11000000000001111100001111110000000001110000000001
100011000000000000001110000011111100000000000000000001
100C11000000011000110000000001111110000000000001100001
11111100000111000M110000000000000000111M01000001100011
11111100000110000111000000000000000111C00100000110M001
100000000001111C10000000111100000000011111000001100001
10000000000000111000000111E111000000000111110001100001
1000000000000000000000011100M1110000000000000001100001
1000000000000000000000111C0000000000000000000001100001
100000011110111111111111111111111111111111100001100001
100000000000000000000110000000011000000000000001111001
100010000M00000000000011CM1100001000000000000001110001
100011000000000000000001110011100000000000000000000001
100011100000000000000000000000000000000000000001111001
100001100000111100100000000000010010000000000001110001
100001110000110001100001111111100011111000000011000001
100M01111100000110000001C0000000M00000C100000001100001
100011111110000000000000111111111111111100000001100M01
100111111111000000000000000000000000000000000001100001
110111111111111111111001111111111111111111100011000011
1C00C111111111111111110C1111111111111111111100011C00C1
111111111111111111111111111111111111111111111111111111
